10
100
5
8 15
0 0 0 0 0 0 0 0
10 15
0 0 0 1 1 1 1 1 1 1 
15 15
2 2 0 0 0 0 0 0 1 1 1 1 1 1 1 
15 15
2 2 2 2 0 0 0 0 1 1 1 1 1 1 1
20 20
2 2 2 2 2 2 2 0 0 0 0 0 0 1 1 1 1 1 1 1
